NO ./texture/bluestone.png
SO ./texture/colorstone.png
WE ./texture/colorstone.png
EA ./texture/colorstone.png

F 220,100,0
C 200,225,3

111111111
100000001
100000001
100000001
100000W01
100000001
100000001
100000W01
111111111